Title: Yoo Ah In là 'Ảnh đế' Rồng Xanh - Link: https://vnexpress.net/yoo-ah-in-la-anh-de-rong-xanh-4234106.html
subData: Yoo Ah In là 'Ảnh đế' Rồng Xanh 
Theo Sports Chosun, hạng mục Nam chính xuất sắc được đánh giá cạnh tranh, gay cấn và khó chọn lựa nhất Rồng Xanh năm nay. Năm tài tử được đề cử - Yoo Ah In, Lee Byung Hun, Lee Jung Jae, Jung Woo Sung và Hwang Jung Min - là những ngôi sao phòng vé và từng đoạt "Ảnh đế".
Trong khoảnh khắc được vinh danh, Yoo Ah In (35 tuổi) đến trước hàng ghế của Lee Byung Hun bắt tay bày tỏ sự ngưỡng mộ với đàn anh. Trước đó, giới chuyên môn cho rằng Byung Hun nắm chắc phần thắng, thậm chí phim The Man Standing Next của anh dẫn đầu giải thưởng với 11 đề cử.
Yoo Ah In nói bất ngờ khi vai Tae In của anh trong Voice of Silence được đánh giá cao. Anh cảm ơn đạo diễn, êkíp sản xuất và khán giả luôn ủng hộ. Theo Daum, tài tử phải tăng 15 kg, cạo đầu khi đóng vai Tae In - kẻ nhận tiền xóa sạch hiện trường gây án của bọn tội phạm, thay chúng chôn thi thể.
Yoo Ah In sinh năm 1986, chạm ngõ màn ảnh từ năm 2003. Giới chuyên môn đánh giá diễn xuất của anh đa dạng, tỏa sáng ở cả mảng điện ảnh lẫn truyền hình. Các dự án Veteran (Chạy đâu cho thoát), Burning (Kẻ giết hổ), Tình yêu bị cấm đoán... giúp anh vươn lên sao hạng A, đoạt nhiều giải thưởng lớn. Trong đó, bom tấn The Throne (Bi kịch vương triều, năm 2015) từng giúp anh trở thành "Ảnh đế" trẻ nhất lịch sử Rồng Xanh, khi mới 29 tuổi.
Ngoài đời, Yoo Ah In cũng cá tính, luôn bộc lộ quan điểm rõ ràng trong nhiều vấn đề nhạy cảm như chính trị, sự biến tướng của phong trào Metoo (tố cáo kẻ cưỡng dâm)... Anh nhiều lần vướng lùm xùm vì không ngại va chạm và cãi tay đôi với anti-fan lẫn truyền thông trên mạng xã hội.
Ở hạng mục Nữ chính xuất sắc (Ảnh hậu), Ra Mi Ran - phim Honest Candidate (Bà hoàng nói dối) - được xướng tên. Cô xúc động, nghẹn ngào khi vượt qua những minh tinh cùng được đề cử như Kim Hee Ae, Jeon Do Yeon, Jung Yu Mi... Các đồng nghiệp hô vang tên Ra Mi Ran, cổ vũ cô hoàn thành bài phát biểu.
Hạng mục Phim hay nhất thuộc về The Man Standing Next (Người kế nhiệm), do Woo Min Ho đạo diễn, Lee Byung Hun đóng chính. Tác phẩm lấy bối cảnh Hàn Quốc trong hai thập niên 1960 và 1970, thời kỳ Park Chung Hee giữ ghế tổng thống gần 18 năm. Lúc này, quốc gia châu Á phát triển mạnh về kinh tế, được mệnh danh là "Kỳ tích sông Hán". Tuy nhiên, tình hình xã hội bất ổn với nhiều vụ đấu đá chính trị, bạo loạn. Kịch bản phim dựa trên cuốn tiểu thuyết cùng tên, xoay quanh vụ 40 ngày cuối cùng của tổng thống Park Chung Hee trước khi bị ám sát năm 1979. Tác phẩm hiện được Hàn Quốc chọn tham dự Oscar 2021.
Trang Daum, Hancinema đánh giá lễ trao giải năm nay hoành tráng, quy tụ nhiều minh tinh, tài tử. Sự kiện diễn ra không khán giả, các nghệ sĩ được đo thân nhiệt, phải đeo khẩu trang và ngồi cách nhau 2 m theo quy định phòng chống dịch của chính phủ.
Rồng Xanh (Blue Dragon Film Award) lần thứ 41 có 15 hạng mục chính. Tác phẩm được đề cử công chiếu từ ngày 11/10/2019 đến ngày 29/10/2020, do các chuyên gia trong ngành điện ảnh và khán giả bình chọn.
Danh sách giải thưởng Rồng Xanh 2020
- Phim hay nhất: The Man Standing Next
- Đạo diễn xuất sắc: Lim Dae Hyung (Moonlit Winter)
- Nam diễn viên xuất sắc (Ảnh đế): Yoo Ah In (phim Voice of Silence)
- Nữ diễn viên xuất sắc (Ảnh hậu): Ra Mi Ran (Honest Candidate)
- Nam diễn viên phụ xuất sắc: Park Jung Min (Deliver Us From Evil)
- Nữ diễn viên phụ xuất sắc: Esom (Samjin Company English Class)
- Đạo diễn mới xuất sắc: Hong Eui Jung (Voice of Silence)
- Nam diễn viên mới xuất sắc: Teo Yoo (Vertigo)
- Nữ diễn viên mới xuất sắc: Kang Mal Geum (Lucky Chan Sil)
- Kịch bản hay nhất: Dae Hyung Lim (Moonlit Winter)
- Ánh sáng xuất sắc: Hong Kyung Pyo (Deliver Us from Evi)
- Biên tập xuất sắc: Han Mi Yeon (Beasts Clawing at Straws)
- Chỉ đạo nghệ thuật xuất sắc: Bae Jeong Yoon (Samjin Company English Class)
- Âm nhạc xuất sắc: Dalpalan (Samjin Company English Class)
- Kỹ xảo xuất sắc: Jin Jong Hyun (phim Ashfall)
- Phim ngắn hay nhất: The Thread (đồng đạo diễn Minjae Cho và Lee Na-yeon)
- Ngôi sao được yêu thích nhất: Yoo Ah In (Voice of Silence), Jung Yoo Mi (Kim Ji Young, Born in 1982)
- Phim được yêu thích nhất do khán giả bình chọn: Ashfall
Đông Trà (ảnh: Sports Chosun)
